*************************************
*.....................**............*
*.****.*****.*****...**...*****.*****
*.*......................*..........*
*.*.***.***********.*****.*********.*
*.*.............................*...*
*.************.*****.***********.*.**
*.................................*.*
*.************.**.***********.****.**
*..............**...................*
*.************.**.*****.***********.*
*...................................*
*.************.*****.***********.****
*...................................*
*.************.*******.************.*
*...................................*
*.************.**.*****.***********.*
*...................*...............*
*************************************
