*******************************
*.............................*
*.............................*
***.***********.**...**********
*...*.........................*
*.*.****.*..*...........*.....*
*.*......*..*.****..*...*..*..*
*.*.******..*.***....**.*.....*
*.*...........****..**.....*..*
*.******.***.........**.......*
*..........******..*******.****
*.............................*
**.***.****......***...********
*.............................*
*.............................*
*.............................*
*.............................*
*******************************
